"filename", "language", "Java", "XML", "comment", "blank", "total"
"/Users/mohammadmahdi/Desktop/Projects/BP_Workshop/TA-AP-Project/.idea/misc.xml", "XML", 0, 6, 0, 0, 6
"/Users/mohammadmahdi/Desktop/Projects/BP_Workshop/TA-AP-Project/.idea/modules.xml", "XML", 0, 8, 0, 0, 8
"/Users/mohammadmahdi/Desktop/Projects/BP_Workshop/TA-AP-Project/.idea/uiDesigner.xml", "XML", 0, 124, 0, 0, 124
"/Users/mohammadmahdi/Desktop/Projects/BP_Workshop/TA-AP-Project/.idea/vcs.xml", "XML", 0, 6, 0, 0, 6
"/Users/mohammadmahdi/Desktop/Projects/BP_Workshop/TA-AP-Project/AP-TA.iml", "XML", 0, 11, 0, 0, 11
"/Users/mohammadmahdi/Desktop/Projects/BP_Workshop/TA-AP-Project/src/Main.java", "Java", 6, 0, 0, 3, 9
"/Users/mohammadmahdi/Desktop/Projects/BP_Workshop/TA-AP-Project/src/controller/Game.java", "Java", 55, 0, 0, 17, 72
"/Users/mohammadmahdi/Desktop/Projects/BP_Workshop/TA-AP-Project/src/controller/GameController.java", "Java", 58, 0, 3, 18, 79
"/Users/mohammadmahdi/Desktop/Projects/BP_Workshop/TA-AP-Project/src/controller/GameLoop.java", "Java", 32, 0, 0, 16, 48
"/Users/mohammadmahdi/Desktop/Projects/BP_Workshop/TA-AP-Project/src/controller/MovementController.java", "Java", 30, 0, 1, 12, 43
"/Users/mohammadmahdi/Desktop/Projects/BP_Workshop/TA-AP-Project/src/controller/MyProject.java", "Java", 8, 0, 0, 4, 12
"/Users/mohammadmahdi/Desktop/Projects/BP_Workshop/TA-AP-Project/src/model/Circle.java", "Java", 15, 0, 0, 8, 23
"/Users/mohammadmahdi/Desktop/Projects/BP_Workshop/TA-AP-Project/src/model/Curve.java", "Java", 21, 0, 0, 6, 27
"/Users/mohammadmahdi/Desktop/Projects/BP_Workshop/TA-AP-Project/src/model/GameObject.java", "Java", 61, 0, 0, 20, 81
"/Users/mohammadmahdi/Desktop/Projects/BP_Workshop/TA-AP-Project/src/model/Movable.java", "Java", 11, 0, 0, 5, 16
"/Users/mohammadmahdi/Desktop/Projects/BP_Workshop/TA-AP-Project/src/model/Point.java", "Java", 19, 0, 0, 6, 25
"/Users/mohammadmahdi/Desktop/Projects/BP_Workshop/TA-AP-Project/src/view/CircleView.java", "Java", 16, 0, 0, 4, 20
"/Users/mohammadmahdi/Desktop/Projects/BP_Workshop/TA-AP-Project/src/view/CurveView.java", "Java", 24, 0, 0, 8, 32
"/Users/mohammadmahdi/Desktop/Projects/BP_Workshop/TA-AP-Project/src/view/Paintable.java", "Java", 5, 0, 0, 3, 8
"/Users/mohammadmahdi/Desktop/Projects/BP_Workshop/TA-AP-Project/src/view/frame/GameFrame.java", "Java", 14, 0, 0, 3, 17
"/Users/mohammadmahdi/Desktop/Projects/BP_Workshop/TA-AP-Project/src/view/panel/GamePanel.java", "Java", 30, 0, 2, 9, 41
"Total", "-", 405, 155, 6, 142, 708